############################################################
#**********************************************************#
#**********************************************************#
#**********************************************************#
#**********************************************************#
#**********************************************************#
#**********************************************************#
#**********************************************************#
#**********************************************************#
#**********************************************************#
#**********************************************************#
#**********************************************************#
#**********************************************************#
#**********************************************************#
#**********************************************************#
#**********************************************************#
#**********************************************************#
#**********************************************************#
#**********************************************************#
#**********************************************************#
#**********************************************************#
#**********************************************************#
#**********************************************************#
#**********************************************************#
#**********************************************************#
#**********************************************************#
#**********************************************************#
#**********************************************************#
#**********************************************************#
#**********************************************************#
#**********************************************************#
#**********************************************************#
#**********************************************************#
#**********************************************************#
#**********************************************************#
#**********************************************************#
#**********************************************************#
#**********************************************************#
#**********************************************************#
#**********************************************************#
#**********************************************************#
#**********************************************************#
#**********************************************************#
#**********************************************************#
#**********************************************************#
#**********************************************************#
#**********************************************************#
#**********************************************************#
#**********************************************************#
#**********************************************************#
#**********************************************************#
#**********************************************************#
#**********************************************************#
#**********************************************************#
#**********************************************************#
#**********************************************************#
#**********************************************************#
#**********************************************************#
#**********************************************************#
#**********************************************************#
#**********************************************************#
#**********************************************************#
#**********************************************************#
#**********************************************************#
#**********************************************************#
#**********************************************************#
#**********************************************************#
#**********************************************************#
#**********************************************************#
#**********************************************************#
#**********************************************************#
#**********************************************************#
#**********************************************************#
#**********************************************************#
#**********************************************************#
#**********************************************************#
#**********************************************************#
#**********************************************************#
#**********************************************************#
############################################################