############################################################
#**********************************************************#
#**********************************************************#
#**********************************************************#
#**********************************************************#
#**********************************************************#
#**********************************************************#
#****************##**********************##****************#
#****************##**********************##****************#
#**********************************************************#
#**********************************************************#
#**********************************************************#
#**********************************************************#
#**********************************************************#
#**********************************************************#
#**********************************************************#
#**********************************************************#
#**********************************************************#
#**********************************************************#
#**********************************************************#
#**********************************************************#
#*********##*****************##*****************##*********#
#*********##*****************##*****************##*********#
#*********##*****************##*****************##*********#
#*********##*****************##*****************##*********#
#*********##*****************##*****************##*********#
#*********##*****************##*****************##*********#
#*********##*****************##*****************##*********#
#**********************************************************#
#**********************************************************#
#**********************************************************#
#**********************************************************#
#**********************************************************#
#**********************************************************#
#**********************************************************#
#**********************************************************#
#**********************************************************#
#**********************************************************#
#**********************************************************#
#**********************************************************#
#**********************************************************#
#**********************************************************#
#**********************************************************#
#**********************************************************#
#**********************************************************#
#**********************************************************#
#**********************************************************#
#**********************************************************#
#**********************************************************#
#**********************************************************#
#**********************************************************#
#*********##*****************##*****************##*********#
#*********##*****************##*****************##*********#
#*********##*****************##*****************##*********#
#*********##*****************##*****************##*********#
#*********##*****************##*****************##*********#
#*********##*****************##*****************##*********#
#*********##*****************##*****************##*********#
#**********************************************************#
#**********************************************************#
#**********************************************************#
#**********************************************************#
#**********************************************************#
#**********************************************************#
#**********************************************************#
#**********************************************************#
#**********************************************************#
#**********************************************************#
#**********************************************************#
#**********************************************************#
#**********************************************************#
#****************##**********************##****************#
#****************##**********************##****************#
#**********************************************************#
#**********************************************************#
#**********************************************************#
#**********************************************************#
#**********************************************************#
#**********************************************************#
############################################################