############################################################
#**********************************************************#
#**********************************************************#
#**********************************************************#
#**********************************************************#
#**********************************************************#
#**********************************************************#
#****************##**********************##****************#
#****************##**********************##****************#
#**********************************************************#
#**********************************************************#
#**********************************************************#
#**********************************************************#
#**********************************************************#
#**********************************************************#
#**********************************************************#
#**********************************************************#
#**********************************************************#
#**********************************************************#
#**********************************************************#
#**********************************************************#
#*********##*****************##*****************##*********#
#*********##*****************##*****************##*********#
#*********##*****************##*****************##*********#
#*********##*****************##*****************##*********#
#*********##*****************##*****************##*********#
#*********##*****************##*****************##*********#
#*********##*****************##*****************##*********#
#**********************************************************#
#**********************************************************#
#**********************************************************#
#**********************************************************#
#**********************************************************#
#**********************************************************#
#**********************************************************#
#*********************###**********###*********************#
#*********************###**********###*********************#
#*********************###**********###*********************#
#************************##########************************#
#************************##########************************#
#************************##########************************#
#*********************###**********###*********************#
#*********************###**********###*********************#
#*********************###**********###*********************#
#**********************************************************#
#**********************************************************#
#**********************************************************#
#**********************************************************#
#**********************************************************#
#**********************************************************#
#**********************************************************#
#*********##*****************##*****************##*********#
#*********##*****************##*****************##*********#
#*********##*****************##*****************##*********#
#*********##*****************##*****************##*********#
#*********##*****************##*****************##*********#
#*********##*****************##*****************##*********#
#*********##*****************##*****************##*********#
#**********************************************************#
#**********************************************************#
#**********************************************************#
#**********************************************************#
#**********************************************************#
#**********************************************************#
#**********************************************************#
#**********************************************************#
#**********************************************************#
#**********************************************************#
#**********************************************************#
#**********************************************************#
#**********************************************************#
#****************##**********************##****************#
#****************##**********************##****************#
#**********************************************************#
#**********************************************************#
#**********************************************************#
#**********************************************************#
#**********************************************************#
#**********************************************************#
############################################################